##################################################
#..........SSSSSS................................#
#.WWW......SSSSSSSS..............................#
#.WWW......SSSSSSSS.......WWWW.......GG..........#
#.WWW...........SSS.....WWWWWW.......G...........#
#.......................WWWWWW............WWW....#
#.......................WWWWWW............WWW....#
#.......................WWWWWW..........WWWWW....#
#..WWW...................WWWWW..........WWWWWW...#
#.WWWWW.......SSSSS......WWWW...........WWWWWW...#
#.WWWWW......SSSSSS......WWWW...........WWWWWW...#
#.WWWWW......SSSSSSSS...................WWWWWW...#
#.WWWWW......SSSSSSSS...................WWWW.....#
#............SSSSSSSS............................#
#............SSSSSSSS............................#
#..............SSSSSS.........................G..#
#..............SSSSSS.........................G..#
#...GG..........SSSSS........GG..................#
#................................................#
#.....................................WWWW.......#
#.....................................WWWW.......#
#.....................................WWWW.......#
#.....................................WWW........#
#........WWWW....................................#
#........WWWWWWW.................................#
#.....G..WWWWWWW.........SSSSSS..................#
#.....G...WWWWWW.........SSSSSSS.................#
#.........WWWWWW.........SSSSSSS........SSSS.....#
#...........WWW..........SSSSSSS........SSSS.....#
#........................SSSSSSS........SSSSS....#
#..SSS...................SSSSSSS........SSSSS....#
#SSSSS....................SSSSS.........SSSSS....#
#SSSSS...................................SSSS....#
#SSSSS.........GG................................#
#SSSSS...........................................#
#SSSSS...........................................#
#SSSSS.............................WWWW..........#
#SSSSS...............SSSS.........WWWWWW.........#
#...................SSSSSS........WWWWWW.....G...#
#...................SSSSSS........WWWWWW.....G...#
#........WWWW.......SSSSSS........WWWWWW.........#
#........WWWW.......SSSSSS.........WWWW..........#
#.......WWWWW.......SSSSSS.......................#
#.......WWWWW...G...SSSSSSSS...............SSSS..#
#.......WWWWW...G...SSSSSSSS..............SSSSS..#
#.......................SSSS..............SSSSS..#
#.........................................SSSSS..#
#.GG.............................................#
#................................................#
##################################################